10010000000C1
1E00000111101
1P0011D000001
1111111111111
