1111111111111
10010000000C1
1e00000111101
1P0011W000001
1111111111111
