1111111111111
10010000000C1
1110001111101
1C10001C11101
1010001000001
1010001111101
1P00110E00001
1111111111111
